1100000000000000000000000000011
1100000000000000000000000000011
1100000000000000000000000000011
1100000044442444400000000000011
1100000000002000000000000000011
1100000000002000000000000000011
1100000000002000000000000000011
1100000000002000000000000000011
1100000000002000000000000000011
1103333000044440000000000000011
1100000000002000000000000000011
1100000000002000000000000000011
1100000000002000003000000000011
1111111111111100000000000000011
1100000000000000000000000000011
1100000000000000044444000000011
1100300000000000000000000000011
1100000004444440000000000000011
1100000000000000000000000000011
1100000000000000300000000000011
1111110000000000000000011
1111111111110000000000000000011
1100000000000000000000000000011
1111111111111111111111111111111

0 336 336
4 32 336 256 336 0.5
3
