11111111111111111111
10000000000000000001
10000000000000000001
10000000000000000001
14444440004444440001
10000000000000000001
10000000000000000001
10000000000000000001
10004444400044444441
10000000000000000001
10000000000000000001
10000000000000000001
10000444444444400001
10000000000000000001
10000000000000000001
10000000000000000001
10000000000004444441
10000000000000000001
10000000000000000001
11111111111111111111

#4 2 600 160 176 300 136 0 0
#4 2 600 160 176 300 0 136 0
#4 2 600 160 176 0 136 136 0
#4 2 600 160 176 100 136 136 0
#4 2 600 160 176 200 136 136 0
#4 2 600 160 176 300 136 136 0
#4 2 600 160 176 400 136 136 0
#4 2 600 160 176 500 136 136 0
0 32 48
1 96 96
1 128 128
1 160 160