11111111111111111111
10000000000000000001
10000000000000000001
10000000000000000001
14444444444444440001
10000000000000000001
10000000000000000001
10000000000000000001
10004444444444444441
10000000000000000001
10000000000000000001
10000000000000000001
14444444444444400001
10000000000000000001
10000000000000000001
10000000000000000001
10004444444444444441
10000000000000000001
10000000000000000001
11111111111111111111

4 2 600 160 176 300 136 0 0
4 2 600 160 176 300 0 136 0
4 2 600 160 176 0 136 136 0
4 2 600 160 176 100 136 136 0
4 2 600 160 176 200 136 136 0
4 2 600 160 176 300 136 136 0
4 2 600 160 176 400 136 136 0
4 2 600 160 176 500 136 136 0
0 32 48
