110000000000000000000011
110000000000000000000011
110000000000000000000011
110000004444244440000011
110000000000200000000011
110000000000200000000011
110000000000200000000011
110000000000200000000011
110000000000200000000011
110333300004444000000011
110000000000200000000011
110000000000200000000011
110000000000200000300011
111111111111110000000011
110000000000000000000011
110000000000000004444411
110030000000000000000011
110000000444444000000011
110000000000000000000011
110000000000000030000011
114444400000000000000011
110000000000000000000011
110000000000000000000011
111111111111111111111111

0 336 336
3
