000000000000000000000000000000000000000000000
000000000000000000000000000000000000000000000
000000000010000000000000000000000000000000000
000000000010000000000000000000000000000000000
000001000010000000000000000000000000000000000
000001000010000000000000000000000000000000000
100001000010000000000000000000000000000000000
111111111111111111111111111111111111111111111

0 16 16
1 0 0
