0000000000000000
0111111111111110
0100000000000310
0100000330000310
0101100000011310
0100110000010210
0100110000010210
0110111111110210
0100000000000210
0100000000000210
0111111110011110
0100000000000010
0100000000000010
0111111100000010
0000000111111110
0000000000000000