0000000000000000
0111111111111110
0100000000000010
0100000000000010
0101100000011010
0100110000010010
0100110000010010
0110111111110110
0100000000000010
0100000000000010
0111111110011110
0100000000000010
0100000000000010
0111111100000010
0000000111111110
0000000000000000