0000000000000000000000000000000000000000000000000000000000000000
0000000000000000000000000000000000000000000000000000000000000000
0000000000000000000000000000000000000000000000000000000000000000
0000000000000000000000200000000000000000000000000000000000000000
0000000000000000000000211111111111111110000000000000000000000000
0000000000000000000000200000000000000011111000000000000000000000
0000000000000000000000200000000000000000000000000000000000000000
0000000000000000000000200000000000000000000000000100000000000000
0000000000000000000000200000000000010000000000001110000000000000
1000000000000000000000100000000000111000000000011111000000000000
1000000000001000000001110000000011111100000000111111110000000000
1111111111111111111111111111111111111111111111111111111111111111
0000000000000000000000000000000000000000000000000000000000000000